11111111
1P00T0C1
1TT01001
1E0000T1
11111111