1111111
1P10001
110E1C1
1111111