1111111
1P1T001
100E1C1
1111111