11111111111111111111111111111
1000000000C00000C000000000001
10100100E00101001000000010101
10000100001001000100100000001
1P00C00C000000000C00000000001
10001000C01110001100000001001
10000001000000000001000000001
11111111111111111111111111111