11111111111111111111111111111
1000000000C00000C000000000001
10100100E00101001000000010101
11000100001001000100100T00001
1P10C00C000000000C00T00000001
11001000C01110001100000001001
100000010000000000010T0000001
11111111111111111111111111111